30,30,
0,0,0,0,0,0,0,0,0,0,0,0,0,0,0,0,0,0,0,0,0,0,0,0,0,0,0,0,0,0,
0,0,0,0,0,0,0,0,0,0,0,0,0,0,0,0,0,0,0,0,0,0,0,0,0,0,0,0,0,0,
0,0,4,4,4,4,4,4,4,4,4,4,4,4,4,4,4,4,4,4,4,4,4,4,3,13,3,4,0,0,
0,0,4,3,3,3,3,3,3,3,3,3,3,3,3,3,3,4,4,3,3,3,3,3,3,2,3,4,0,0,
0,0,4,3,8,2,2,2,2,2,2,2,1,2,2,2,3,4,4,3,1,2,2,2,2,2,3,4,0,0,
0,0,4,3,2,2,2,2,2,2,2,2,2,2,2,2,3,3,3,3,2,2,2,6,2,2,3,4,0,0,
0,0,4,3,2,2,2,2,1,2,1,2,2,1,2,2,2,2,2,2,2,2,2,2,2,2,3,4,0,0,
0,0,4,3,2,2,2,2,1,6,1,2,2,2,2,2,3,3,3,3,2,2,2,2,2,2,3,4,0,0,
0,0,4,3,6,6,2,3,2,2,2,3,2,2,6,6,3,4,4,3,3,3,3,2,2,2,3,4,0,0,
0,0,4,3,2,2,2,3,0,0,0,3,2,2,6,6,3,4,4,4,4,4,3,2,6,2,3,4,0,0,
0,0,4,3,2,2,2,3,0,0,0,3,2,2,2,2,3,4,4,4,4,4,3,2,2,1,3,4,0,0,
0,0,4,3,1,1,1,3,0,0,0,3,1,1,1,1,3,3,3,3,3,3,3,2,2,2,3,4,0,0,
0,0,4,3,2,2,2,3,3,0,3,3,2,2,2,2,3,3,3,3,6,2,2,2,2,2,3,4,0,0,
0,0,4,3,2,6,1,2,2,0,2,2,2,2,2,2,2,2,2,2,2,2,1,2,2,2,3,4,0,0,
0,0,4,3,2,6,6,2,2,0,2,2,2,1,2,2,3,3,3,3,2,2,2,2,2,2,3,4,0,0,
0,0,4,3,1,2,2,2,2,0,2,2,2,2,2,2,3,4,4,3,2,2,2,2,2,2,3,4,0,0,
0,0,4,3,3,3,3,3,3,0,3,3,3,3,3,3,3,4,4,3,3,3,2,3,3,3,3,4,0,0,
0,0,4,3,3,3,3,3,0,0,0,3,3,3,3,3,3,4,4,4,4,3,2,3,4,4,4,4,0,0,
0,0,4,3,3,3,3,3,0,0,0,3,3,3,3,3,3,4,3,3,3,3,2,3,3,3,3,4,0,0,
0,0,4,3,3,3,3,3,3,0,3,3,3,3,3,3,3,3,3,2,2,2,2,2,2,2,3,4,0,0,
0,0,4,3,0,0,0,0,0,0,0,0,0,0,0,0,3,3,3,1,0,0,9,0,0,1,3,4,0,0,
0,0,4,3,0,0,0,0,0,0,0,0,0,0,0,0,3,3,3,2,0,6,1,6,0,2,3,4,0,0,
0,0,4,3,0,0,0,0,0,0,0,0,0,0,0,0,2,6,2,2,0,2,1,2,0,2,3,4,0,0,
0,0,4,3,0,0,0,0,0,0,0,0,0,0,0,0,3,3,3,2,2,1,1,1,2,2,3,4,0,0,
0,0,4,3,9,0,0,0,0,9,0,0,0,0,0,9,3,3,3,2,2,2,2,2,2,2,3,4,0,0,
0,0,4,3,3,3,3,3,3,3,3,3,3,3,3,3,3,3,3,3,3,3,3,3,3,3,3,4,0,0,
0,0,4,4,4,4,4,4,4,4,4,4,4,4,4,4,4,4,4,4,4,4,4,4,4,4,4,4,0,0,
0,0,0,0,0,0,0,0,0,0,0,0,0,0,0,0,0,0,0,0,0,0,0,0,0,0,0,0,0,0,
0,0,0,0,0,0,0,0,0,0,0,0,0,0,0,0,0,0,0,0,0,0,0,0,0,0,0,0,0,0,
0,0,0,0,0,0,0,0,0,0,0,0,0,0,0,0,0,0,0,0,0,0,0,0,0,0,0,0,0,0,