10,20,
4,4,4,4,4,4,4,4,4,4,
4,4,4,4,4,4,4,4,4,4,
4,4,13,2,2,2,2,2,4,4,
4,4,0,9,0,9,0,9,4,4,
4,4,0,3,3,3,3,0,4,4,
4,4,0,0,0,0,0,0,4,4,
4,4,3,3,3,3,3,2,4,4,
4,4,2,2,2,2,2,6,4,4,
4,4,2,2,2,2,2,2,4,4,
4,4,2,2,2,2,2,2,4,4,
4,4,2,2,2,2,2,2,4,4,
4,4,2,2,2,2,2,2,4,4,
4,4,2,2,2,2,2,2,4,4,
4,4,0,9,0,9,0,9,4,4,
4,4,0,3,3,3,3,0,4,4,
4,4,0,0,0,0,0,0,4,4,
4,4,6,3,3,3,3,3,4,4,
4,4,2,6,2,2,2,8,4,4,
4,4,4,4,4,4,4,4,4,4,
4,4,4,4,4,4,4,4,4,4,